########################
*************###########
#########****###########
###########*############
###########*###****######
############***#*#*####
################***#####
##################******
########################
########################
########################
########################
########################
########################