########****############
****############***######
###*******###############
##########*****##########
##############*****######
####********************
##########*****##########
##############*****######
####********************